level1
0000000000000000
0344411111111140
0442333333321110
0423444444432110
0434444444443110
0134443334443110
0423333334443110
0122234444432110
0122234443322110
0122223332222110
0122234443222110
0122234443222110
0112223332221110
0111111111111110
0311111111111130
0000000000000000

level2
4321000000001234
3432100000012343
2343210000123432
1234321001234321
0123432112343210
0012343223432100
0001234334321000
0000123443210000
0000123443210000
0001234334321000
0012343223432100
0123432112343210
1234321001234321
2343210000123432
3432100000012343
4321000000001234
